1111111111111111111
1CCCCCCC0E0CCCCCCC1
11111111C1C111111C1
1CCC1011CCC1101CCC1
11111011C1111011111
1CCCCC1111111CCCCC1
1C11111111111111111
1CCCCCCC000CCCCCCC1
1C111111C1C111111C1
1C1CCCCCC1CCCCCC1C1
1CCC1C11CCC1101CCC1
11111C1111111011111
1CCCCC1111111CCCCC1
1C11111111111111111
1CCCCCCC000CCCCCCC1
1C111111C1C111111C1
1C1CCCCCC1CCCCCC1C1
1CCC1C11C0C1101CCC1
11111C111P111011111
1CCCCC1111111CCCCC1
1111111111111111111